{
	"idMap":[
		[3, 3, 3, 1, 1, 1, 1, 1, 1, 1, 1, 1, 1, 1, 1, 1, 1, 1, 1, 1, 1, 1, 1, 1, 1, 0, 0, 0],
		[0, 0, 0, 1, 2, 2, 2, 2, 2, 2, 2, 2, 2, 1, 1, 2, 2, 2, 2, 2, 2, 2, 2, 2, 1, 0, 0, 0],
		[1, 1, 1, 1, 1, 1, 1, 1, 1, 0, 0, 0, 2, 1, 1, 2, 0, 0, 0, 1, 1, 1, 1, 1, 1, 1, 1, 1],
		[1, 2, 2, 2, 2, 2, 2, 0, 0, 2, 1, 1, 2, 1, 1, 2, 1, 1, 2, 0, 0, 2, 2, 2, 2, 2, 2, 1],
		[1, 2, 1, 1, 1, 1, 2, 0, 2, 2, 1, 0, 2, 2, 0, 2, 0, 1, 2, 2, 0, 2, 1, 1, 1, 1, 2, 1],
		[1, 2, 1, 2, 2, 2, 2, 1, 1, 1, 1, 0, 1, 1, 1, 1, 0, 1, 1, 1, 1, 2, 2, 2, 2, 1, 2, 1],
		[1, 2, 1, 2, 1, 1, 1, 1, 2, 0, 0, 0, 2, 1, 1, 2, 0, 0, 0, 2, 1, 1, 1, 1, 2, 1, 2, 1],
		[1, 2, 1, 2, 1, 2, 2, 2, 2, 0, 0, 1, 2, 2, 2, 2, 1, 0, 0, 2, 2, 2, 2, 1, 2, 1, 2, 1],
		[1, 2, 1, 2, 2, 1, 1, 1, 2, 1, 0, 1, 1, 1, 1, 1, 1, 0, 1, 2, 1, 1, 1, 2, 2, 1, 2, 1],
		[1, 2, 1, 2, 2, 1, 1, 1, 2, 1, 0, 1, 0, 0, 0, 0, 1, 0, 1, 2, 1, 1, 1, 2, 2, 1, 2, 1],
		[1, 2, 2, 2, 2, 1, 1, 1, 2, 1, 0, 1, 0, 0, 0, 0, 1, 0, 1, 2, 1, 1, 1, 2, 2, 2, 2, 1],
		[1, 1, 1, 1, 2, 1, 1, 1, 2, 1, 0, 1, 1, 0, 0, 1, 1, 0, 1, 2, 1, 1, 1, 2, 1, 1, 1, 1],
		[0, 0, 0, 1, 2, 2, 2, 2, 2, 2, 2, 2, 0, 0, 0, 2, 2, 2, 2, 2, 2, 2, 2, 2, 1, 0, 0, 0],
		[0, 0, 0, 1, 1, 1, 1, 1, 1, 1, 1, 1, 1, 1, 1, 1, 1, 1, 1, 1, 1, 1, 1, 1, 1, 0, 0, 0]
	],
	"playerPositionX":14,
	"playerPositionY":4,
	"enemyPositions": [
		{
			"posX":13,
			"posY":9
			},
		{
			"posX":13,
			"posY":10
		},
		{
			"posX":13,
			"posY":9
			},
		{
			"posX":13,
			"posY":10
		},
		{
			"posX":13,
			"posY":9
			},
		{
			"posX":13,
			"posY":10
		}
		],
	"name":"level1"
}