{
	"idMap":[
		[3, 3, 3, 1, 1, 1, 1, 1, 1, 1, 1, 1, 1, 1, 1, 1, 1, 1, 1, 1, 1, 1, 1, 1, 1, 0, 0, 0],
		[0, 0, 0, 1, 2, 2, 2, 1, 2, 2, 2, 2, 2, 1, 2, 2, 2, 2, 2, 2, 1, 2, 2, 2, 1, 0, 0, 0],
		[1, 1, 1, 1, 2, 1, 2, 2, 2, 1, 1, 1, 2, 1, 2, 1, 1, 2, 1, 2, 2, 2, 1, 2, 1, 1, 1, 1],
		[1, 0, 0, 1, 2, 1, 1, 2, 1, 1, 1, 1, 2, 1, 2, 1, 2, 2, 1, 1, 2, 1, 1, 2, 1, 0, 0, 1],
		[1, 0, 0, 1, 1, 1, 2, 2, 1, 1, 1, 1, 2, 1, 2, 1, 1, 1, 1, 1, 2, 2, 1, 2, 1, 0, 0, 1],
		[1, 0, 0, 1, 1, 1, 2, 1, 1, 2, 2, 2, 2, 0, 2, 2, 2, 2, 2, 1, 1, 2, 1, 1, 1, 0, 0, 1],
		[1, 0, 0, 0, 2, 2, 2, 2, 1, 2, 1, 1, 1, 0, 1, 1, 1, 1, 2, 1, 2, 2, 2, 2, 0, 0, 0, 1],
		[1, 1, 1, 1, 1, 2, 1, 2, 1, 0, 1, 2, 0, 0, 0, 0, 2, 1, 0, 1, 2, 1, 2, 1, 1, 1, 1, 1],
		[1, 2, 2, 2, 1, 2, 1, 2, 1, 0, 1, 0, 1, 1, 1, 1, 0, 1, 0, 1, 2, 1, 2, 1, 2, 2, 2, 1],
		[1, 2, 1, 1, 1, 2, 1, 2, 1, 0, 1, 0, 1, 1, 1, 1, 0, 1, 0, 1, 2, 1, 2, 1, 1, 1, 2, 1],
		[1, 2, 1, 2, 2, 2, 1, 2, 2, 2, 1, 2, 0, 0, 0, 0, 2, 1, 2, 2, 2, 1, 2, 2, 2, 1, 2, 1],
		[1, 2, 1, 2, 1, 1, 1, 2, 1, 2, 1, 1, 1, 1, 1, 1, 1, 1, 2, 1, 2, 1, 1, 1, 2, 1, 2, 1],
		[1, 2, 2, 2, 2, 2, 2, 2, 1, 2, 2, 2, 0, 0, 0, 2, 2, 2, 2, 1, 2, 2, 2, 2, 2, 2, 2, 1],
		[1, 1, 1, 1, 1, 1, 1, 1, 1, 1, 1, 1, 1, 1, 1, 1, 1, 1, 1, 1, 1, 1, 1, 1, 1, 1, 1, 1]
	],
	"playerPositionX":13,
	"playerPositionY":12,
	"enemyPositions": [
		{
			"posX":2,
			"posY":3
			},
		{
			"posX":1,
			"posY":4
		},
		{
			"posX":25,
			"posY":3
			},
		{
			"posX":26,
			"posY":4
		}
		],
	"name":"level2"
}